1111111111111
1001C000000C1
1000011111001
1P0011E00E001
1111111111111