1111111111111
100C000C00001
1000110000001
10P10CE000C01
1111111111111