111111
100001
101C01
101P01
101E01
111111