111111
100001
101001
101P01
1C1E01
111111