111111111
100000001
100010111
1100P0C11
1010000E1
111111111

111111111
100000001
100010111
1100P0C11
1010000E1
111111111