1111111111111
100C000C00001
1000110000001
10P10C10000E1
1111111111111